#HEADER
mainTitle:DoodleJump
subTitle:Tutorial
gameType:doodlejump
scrollType:upHorizontal
deathsAllowed:1
backgroundImage:levelBackground.png
levelWidth:16
levelHeight:40
#ENTITIES
X:DoodleBoi
E:Enemy
S:Spring
L:BreakableStepLeft
R:BreakableStepRight
1:UnbreakableStepLeft
2:UnbreakableStepRight
T:Trampoline
#LEVEL
. . . . . . . . . . . L R . . .
. . . . . . . . . . . . . . . .
. . . . . . . . . . . . . . . .
. . L R . . . . . . . . . . . .
. . . . . . . . . . . . . . . .
. . . . . . . . . . . 1 2 . . .
. . . . . . . . . . . . . . . .
. . . . . . . . . . . . . . . .
. . . . . . . . 1 2 . . . . . .
. . . . . . . . . . . . . . . .
. . . . . . . . . . . . . . . .
. 1 2 . . . . . . . . . . . . .
. . . . . . . . . . . . . . . .
. . . . . . . . . . . L R . . .
. . . . . . . . . . . . . . . .
. . . . . . T . . . . . . . . .
. . . . . L R . . . . . . . . .
. . . . . . . . . . . . . . . .
. . . . . . . . . . . . . . . .
. 1 2 . . . . . . . . . . . . .
. . . . . . . . . . . . . . . .
. . . . 1 2 . . . L R . . . . .
. . . . . . . . . . . . . . 1 2
. . . . . . . . . . . . . . . .
. . L R . . . . E . . . . . . .
. . . . . . . . . . . . . T . .
. . . . . . . . . . . . L R . .
. . . . L R . . . . . . . . . .
. S . . . . . . . . . . . . . .
. 1 2 . . . . . . . . . . . 1 2
. . . . . . . L R . . . . . . .
L R . . . . . . . . . L R . . .
. . . 1 2 . . . . . . . . . . .
. . . . . . . . . . . . . . 1 2
. . . . . . L R . . . . . . . .
. . L R . . . . X . . S . . . .
. . . . . S . . . . . 1 2 . . .
. . . . 1 2 . . . . . . . . S .
. . . . . . . . . S . . . . L R
. . . . . . . . 1 2 . . . . . .
#END