#HEADER
id:0001
mainTitle:Testing Level
subTitle:Tutorial
gameType:mario
scrollType:horizontal
deathsAllowed:1
backgroundImage:images/gameBackground.png
levelWidth:50
levelHeight:12
#ENTITIES
F:Flag
1:Goomba
?:QuestionBrick
B:Brick
0:Koopa
T:Brick
X:Player
G:Ground
L:GroundLeft
R:GroundRight
C:Coin
6:GroundCenter
M:BigMushroom
I:LifeMushroom
S:MiniMushroom
#LEVEL
. . . . . . . . . . . . . . . . . . . . . . . . . . . . . . . . . . . . . . . . . . . . . . . . . .
. . . . . . . . . . . . . . . . . . . . . . . . . . . . . . . . . . . . . . . . . . . . . . . . . .
. . . . . . . . . . . . . . . . . . . . . . . . . . . . . . . . . . . . . . . . . . . . . . . . . .
. . . . . . . . . . . . . . . . . . . . . . . . . . . . . . . . . . . . . . . . . . . . . . . . . .
. . . . . . . . . . . . . . . . . . . . . . . . . . . . . . . . . . . . . . . . . . . . . . . . . .
. . X . . . . . . . . . . . . . . . . . . . . . . . . . . . . . . . . . . . . . . . . . . . . . . .
. . . . . . . . . . . . . . . . . . . . . . . . . . . . . . . . . . . . . . . . . . . . . . . . . .
. . B . . . . . . . . . . . . . . . . . . . . . . . . . . . . . . . . . . . . . . . . . . . . . . .
. . . . . B . . . . . . . . . . . . . . . . . . . . . . . . . . . . . . . . . L G R . . . . . . . .
. . . . . . . . . . . . . . . . . . . . . . . . . . . . . . . . . . . L G G G 6 6 6 G R . . F . . .
. . . . F . C . . S . M . I . . . . . . . . . . . . . . . . . L G G G 6 6 6 6 6 6 6 6 6 G G G G G G
G G G G G G G G G G G G G G G G G G G G G G G G G G G G G G G 6 6 6 6 6 6 6 6 6 6 6 6 6 6 6 6 6 6 6
#END