#HEADER
mainTitle:Testing Level
subTitle:Jump, Jump, Jump!
gameType:mario
scrollType:right
deathsAllowed:1
backgroundImage:levelBackground.png
levelWidth:50
levelHeight:12
#ENTITIES
F:Flag
1:Goomba
?:Brick
B:Brick
0:Koopa
T:Brick
X:Player
G:Ground
C:Coin
6:GroundCenter
#LEVEL
. . . . . . . . . . . . . . . . . . . . . . . . . . . . . . . . . . . . . . . . . . . . . . . . . .
. . . . . . . . . . . . . . . . . . . . . . . . . . . . . . . . . . . . . . . . . . . . . . . . . .
. . . . . . . . . . . . . . . . . . . . . . . . . . . . . . . . . . . . . . . . . C . . . . . . . .
. . . . . . . . . . . . . . . . C . . . . . . . . . . . . . . . . . . . . . . . . C . . . . . . . .
. . . . . . . . C . . . . . . . . . . . . . . . . . . . . . . . . . . B B B B . . C . . . . . . . .
. . . . . . . . . . . . . . . . . . . . . . . . . . . . B B ? B . . . . . . . . . C . . . . . . . .
. . . . . . . . . . . . . . . . . . . . . B B B B . . . . . . . . . . . . . . . . C . . . . . . . .
. . . . . . . . . C . . . . B B ? B . . . . . . . . . . . C C . . . . . . . . . . C . . . . . . . .
. . . . . . . B B B B . . . . . . . . . . . . . . . . . . . . . . . . . . . . . . . . . . F . . . .
. . X . . . . . . . . . . . . . . . . . . . . . . . . . . . . . . . . . . . . . . . . . T T T . . .
. . . . . . . . . . . . 0 . 1 . 0 . 1 . . . . 0 . 1 . 0 . 1 . . . . 0 . 1 . 0 . 1 . . G 6 6 6 G . .
G G G G G G G G G G G G G G G G G G G G G G G G G G G G G G G G G G G G G G G G G G G 6 6 6 6 6 G G
#END