#HEADER
mainTitle:Level 0-4
subTitle:Climb on Up!
gameType:mario
scrollType:up
deathsAllowed:1
backgroundImage:levelBackground.png
levelWidth:20
levelHeight:50
#ENTITIES
F:Flag
1:Goomba
?:QuestionBrick
B:Ground
0:Koopa
S:SolidBrick
X:Player
G:Ground
V:Ground
C:Coin
#LEVEL
. . . . . . . . . . . . . . . . . . . .
. . . . . . . . . . . . . . . . . . . .
. . . . . . . . . . . . . . . . . . . .
. . . . . . . . . . S ? S . . . . . . .
. . . . . . . . . . . . . . . . . . . .
. . . . . . . . . . . . . . . . . . . .
. . . . . . . . . . . . . . . . . . . .
B B B . . . . . . . . . . . . . F . . .
. . . . . . . . . . . . . . . B B B . .
. . . . . . . . . . V G G G G G G G G G
. . . C . . . . . . . . V G G G G G G G
. . . B B B . . . . . . . . . V G G G G
. . . . . . . . . . . . . . . . . V G G
. . . . . . . . . . . . . . . . . . V G
. . . . . . . B B ? B B . . . . . . . V
. . . . . . . . . . . . . . . . . . . .
. . . . . . . . . . . . ? . . . . . . .
. . B B B . . . . . . . . . . . . . . .
. . . . . . . . . . . . . . . . . . . .
. . . . . . . C . . . . C . . . C . . .
. . . . . . B B B B B B B B B C . . . .
. . . . . . . . . . . . . . C . . . . .
. . . . . . . . . . . . . C . . . . . B
. . . . . . . . . . . . C . . . . . . .
B B B . . . . . . . . C . . . . . . . .
. . . . . . . . . . C . . . . . . . . .
. . . . . . . . . C . . . . . . . B B B
. . . . . . . . C . B B B ? ? . . . . .
. . . . . . . C . . . . . . . . . . . .
. . . . . C . . . . . . . . . . . . . .
. . B ? B B . . . . . . . . . . . . . .
. . . . . . . . B B . . . . . . . . . .
. . . . . . . . . . . . . . . . . . . .
. . . . . . . . . . . . . . . . . . . .
. . B B S B . . . . . . . . . . . . . .
. . . . . . . . . . . . B B B B . . . .
. . . . . . . . . . . . . . . . . . . .
. . . . . C . . C . . . . . . . . . . .
. . . . . B B ? B . . . . . . . . . . .
. . . . . . . . . . . . . . . . . . . .
. . . . . . . . . . . . . . . . . . . .
. . . . . . . . . . . . . . . C . . . .
. . . . . . . . . . . B B B B B . . . .
. . . . . . . . . . . . . . . . . . . .
. . . . . . . . B B B . . . . . . . . .
. . B S S B . . . . . . . . . . . ? ? .
. . . . . . . . . . . . . . . . . . . .
. . . . . . . . . X . . . . . . . . . .
. 1 . . . . . . . . . . . . . 0 . . . .
G G G G G G G G G G G S G G G G G G G G
#END